AAAAAAAAAAAAAABCCCCFAAAAAAAAAAAAA
AAAAAAAAAAAAAABCCCCFAAAAAAAAAAAAA
AAAAADAAAAAAAABCCCCFAAAAAAAAAAAAA
AAAAAAEAAAAAAABCCCCFAAAAAAAAAAAAA
AAAAAAAEAAAAAAHGGGGIAAAAAAAAAAAAA
AAAAAAAAAAAAAAAAAAAAAAAAAAAAAAAAA
AAAAAAAAAADAAAAAAAAAAAAAAAAAAAAAA
AAAAAADAAAAAAAAAEAAAAADAAAAAAAAAA
AAAAAAAAAAAAAAAAAAAAAAAAAAAAAAAAA
AAAAAAAAAAAAAAAAAAAAAAAAAAAAAAAAA
AAAAAAAAAADAAAAAAAAAAAAAAAAAAAAAA
AAAAAAAAAAAAAAAAAAAAAAAAAAAAAAAAA
AAAAAAAAAAAAAAAAAAAAAAAAAAAAAAAAA
AAAAAAAAAAAAAAAAAAAAAAAAAAAAAAAAA
AAAAEAAAAAAAAAAAAEAAAAAAKJJJJLEAA
AAAAAAAAAAAAAAAAAAAAAAAABCCCCFAAA
AAAAAAAAAAADAAAAAAAAEAAABCCCMIAAA
AAAAAAAAAAAAAAAAAAAAAAAABMGGIAAAA
AAAAEAAAAAAAAAAAAAAAAAAAHIAAAAAAA
AAAAAAAAAAAAAAAAAAAAAAAAAAAAAAAAA
AAAAAAAAAAAAAAAAAAAAAAAAAAAAEAAAA
AAAAADAAAAAAAAAAADAAAAAAAEAAAAAAA
AAAAAAAAAAAAAAAAAAAAAAAAAAAAAAAAA
AAAAAAAAAAAAAAAAAAAAAAAAADAAAAAAA
AAAAAAAAAAAAAAAAAAAAAAAAAAAAAAAAA
AAAAAAAAAAAAAAAAAAAAAAAAAAAAAAAAA
AAAAAAAAAAAAAADAAAAAAAAAAAAAAAAAA
AAAAAAAAAAAAAAAAAAAAAAAAAAAAAAAAA
AAAAEAAAAAAAAAAAAAAAAAADAAAAAEAAA
AAAAAAAAAAAAAAAAAAAAAAAAAAAAAAAAA
AAAAAAAAAAAAAAAAAAAAAAAAAAAAAAAAA
AAAAAAAADAAAAAAAAAEAAAAAAAAAAAAAA
AAAAAAAAAAAAAAAAAAAAAAAAAAAAAAAAA
AAAAAAAAAAAAADAAAAAAAAAAAAAAAAAAA
AAAAAAAAAAAAAAAAAAAAAAAAAAAAAAAAA
AAAAAAAAAAAAAAAAAAAAAAAAAAAADAAAA
